NO ./xpm/realabd.xpm
SO ./xpm/mo.xpm
WE ./xpm/greystone.xpm
EA ./xpm/purplestone.xpm

F 2147483647,150,150
C 10,10,10

111111111111111111111111111111
1001000000001S1000000000000001
111100000000101000000000000001
10000000000010111000000000011
10000000000010001000000000001
100000000000101010000000000001
100000000011101010000000000001
1000000000100010111000000000001
100000000010101000100000000011
100000000010101010100000000001                 
100000001110101010111000000001                          
10000000100010101000100000001
100000001010101010101000000001
100000001010101010101000000001
100000001010101010101000000001
100111111000001010101010101001
1111  111111111111111111111111
111111111111111111111111111111




                   






               




                           



